Rk,Date,Opponent,Loc.,Result,GF,GA,GD,PDO,PDOA,SF,SA,SD,SH.,SH.A,FOW,FOL,FOD,FO.,SV.,SV.A,HITS,HITSA,HITSD,BS,BSA,BSD,Season
1,2017-04-09,Columbus Blue Jackets,Home,Loss,2,3,-1,0.969,1.031,32,32,0,0.063,0.094,35,24,11,0.5932,0.9063,0.9375,17,22,-5,5,16,-11,2016-17
2,2017-04-08,Pittsburgh Penguins,Home,Win,5,3,2,1,1.029,30,18,12,0.167,0.167,32,27,5,0.5424,0.8333,0.8621,13,32,-19,12,20,-8,2016-17
3,2017-04-06,Tampa Bay Lightning,Home,Loss,1,4,-3,0.904,1.096,27,30,-3,0.037,0.133,50,28,22,0.641,0.8667,0.963,28,35,-7,9,19,-10,2016-17
4,2017-04-04,Washington Capitals,Home,Loss,1,4,-3,0.93,1.07,28,38,-10,0.036,0.105,30,28,2,0.5172,0.8947,0.9643,24,23,1,8,13,-5,2016-17
5,2017-04-03,Buffalo Sabres,Away,Win,4,2,2,0.998,1.002,45,22,23,0.089,0.091,35,30,5,0.5385,0.9091,0.9111,16,15,1,14,12,2,2016-17
6,2017-04-01,Detroit Red Wings,Away,Win,5,4,1,1.09,0.91,27,42,-15,0.185,0.095,26,37,-11,0.4127,0.9048,0.8148,23,29,-6,10,15,-5,2016-17
7,2017-03-30,Nashville Predators,Away,Win,3,1,2,1.143,0.908,17,30,-13,0.176,0.033,29,25,4,0.537,0.9667,0.875,23,18,5,13,11,2,2016-17
8,2017-03-28,Florida Panthers,Home,Win,3,2,1,1.046,0.954,25,27,-2,0.12,0.074,33,25,8,0.569,0.9259,0.88,18,30,-12,13,15,-2,2016-17
9,2017-03-25,Buffalo Sabres,Away,Loss,2,5,-3,0.927,1.073,34,38,-4,0.059,0.132,33,33,0,0.5,0.8684,0.9412,7,20,-13,8,15,-7,2016-17
10,2017-03-23,New Jersey Devils,Home,Win,4,2,2,1.071,0.959,30,32,-2,0.133,0.063,35,24,11,0.5932,0.9375,0.8966,20,40,-20,7,13,-6,2016-17
11,2017-03-22,Columbus Blue Jackets,Away,Win,5,2,3,1.097,0.93,32,34,-2,0.156,0.059,35,21,14,0.625,0.9412,0.871,24,19,5,21,11,10,2016-17
12,2017-03-20,Boston Bruins,Home,Win,4,2,2,1.075,0.987,30,34,-4,0.133,0.059,27,35,-8,0.4355,0.9412,0.9286,20,26,-6,13,13,0,2016-17
13,2017-03-18,Chicago Blackhawks,Home,OT Loss,1,2,-1,0.987,1.013,26,39,-13,0.038,0.051,40,18,22,0.6897,0.9487,0.9615,39,25,14,17,18,-1,2016-17
14,2017-03-16,Tampa Bay Lightning,Away,Win,5,0,5,1.238,0.762,21,33,-12,0.238,0,28,24,4,0.5385,1,0.7619,14,24,-10,17,9,8,2016-17
15,2017-03-14,Florida Panthers,Away,Loss,2,7,-5,0.848,1.152,30,32,-2,0.067,0.219,34,40,-6,0.4595,0.7813,0.9333,17,19,-2,9,12,-3,2016-17
16,2017-03-11,Carolina Hurricanes,Away,OT Win,3,2,1,1.063,0.937,26,38,-12,0.115,0.053,29,33,-4,0.4677,0.9474,0.8846,23,19,4,18,10,8,2016-17
17,2017-03-09,Philadelphia Flyers,Home,Win,4,2,2,1.069,0.959,33,38,-5,0.121,0.053,28,38,-10,0.4242,0.9474,0.9063,13,17,-4,18,14,4,2016-17
18,2017-03-07,Detroit Red Wings,Home,Win,3,2,1,1.024,0.976,28,24,4,0.107,0.083,31,28,3,0.5254,0.9167,0.8929,30,38,-8,11,9,2,2016-17
19,2017-03-03,Anaheim Ducks,Away,Loss,2,5,-3,0.937,1.088,39,36,3,0.051,0.139,33,38,-5,0.4648,0.8857,0.9487,16,19,-3,14,18,-4,2016-17
20,2017-03-02,Los Angeles Kings,Away,SO Loss,2,3,-1,1.007,0.993,31,35,-4,0.065,0.057,38,32,6,0.5429,0.9429,0.9355,25,36,-11,14,14,0,2016-17
21,2017-02-28,San Jose Sharks,Away,Loss,1,3,-2,0.992,1.033,21,37,-16,0.048,0.081,30,31,-1,0.4918,0.9444,0.9524,20,27,-7,18,20,-2,2016-17
22,2017-02-25,Montreal Canadiens,Home,OT Loss,2,3,-1,0.952,1.048,34,28,6,0.059,0.107,26,30,-4,0.4643,0.8929,0.9412,32,37,-5,15,12,3,2016-17
23,2017-02-23,New York Rangers,Home,SO Loss,1,2,-1,1.004,0.996,33,38,-5,0.03,0.026,21,43,-22,0.3281,0.9737,0.9697,21,31,-10,27,12,15,2016-17
24,2017-02-21,Winnipeg Jets,Home,OT Win,5,4,1,0.935,1.065,37,20,17,0.135,0.2,38,33,5,0.5352,0.8,0.8649,32,31,1,6,17,-11,2016-17
25,2017-02-19,Carolina Hurricanes,Away,Win,4,0,4,1.129,0.871,31,37,-6,0.129,0,24,38,-14,0.3871,1,0.871,21,23,-2,17,13,4,2016-17
26,2017-02-18,Ottawa Senators,Home,Loss,3,6,-3,0.983,1.062,36,42,-6,0.083,0.143,31,36,-5,0.4627,0.9,0.9189,23,32,-9,11,18,-7,2016-17
27,2017-02-15,Columbus Blue Jackets,Away,Loss,2,5,-3,0.943,1.082,33,35,-2,0.061,0.143,31,29,2,0.5167,0.8824,0.9394,16,27,-11,10,19,-9,2016-17
28,2017-02-14,New York Islanders,Home,Win,7,1,6,1.141,0.859,41,34,7,0.171,0.029,38,22,16,0.6333,0.9706,0.8293,19,27,-8,4,8,-4,2016-17
29,2017-02-11,Buffalo Sabres,Home,Loss,1,3,-2,0.892,1.108,44,23,21,0.023,0.13,31,27,4,0.5345,0.8696,0.9773,36,41,-5,11,20,-9,2016-17
30,2017-02-09,St. Louis Blues,Home,OT Loss,1,2,-1,0.981,1.019,32,40,-8,0.031,0.05,34,25,9,0.5763,0.95,0.9688,36,27,9,15,17,-2,2016-17
31,2017-02-07,Dallas Stars,Home,Win,3,1,2,1.063,0.937,34,40,-6,0.088,0.025,33,31,2,0.5156,0.975,0.9118,22,30,-8,16,14,2,2016-17
32,2017-02-06,New York Islanders,Away,OT Loss,5,6,-1,0.98,1.02,32,34,-2,0.156,0.176,34,29,5,0.5397,0.8235,0.8438,22,23,-1,21,13,8,2016-17
33,2017-02-04,Boston Bruins,Away,Win,6,5,1,1.109,0.891,26,41,-15,0.231,0.122,31,46,-15,0.4026,0.878,0.7692,30,30,0,19,19,0,2016-17
34,2017-02-02,St. Louis Blues,Away,Loss,1,5,-4,0.876,1.124,27,31,-4,0.037,0.161,29,35,-6,0.4531,0.8387,0.963,33,28,5,6,21,-15,2016-17
35,2017-01-31,Dallas Stars,Away,Loss,3,6,-3,0.77,1.23,43,20,23,0.07,0.3,36,22,14,0.6207,0.7,0.9302,15,20,-5,15,20,-5,2016-17
36,2017-01-26,Philadelphia Flyers,Away,Loss,1,2,-1,0.977,1.023,28,34,-6,0.036,0.059,20,35,-15,0.3636,0.9412,0.9643,29,28,1,18,21,-3,2016-17
37,2017-01-25,Detroit Red Wings,Away,Win,4,0,4,1.143,0.857,28,22,6,0.143,0,28,22,6,0.56,1,0.8571,19,29,-10,12,11,1,2016-17
38,2017-01-23,Calgary Flames,Home,Win,4,0,4,1.143,0.857,28,26,2,0.143,0,35,28,7,0.5556,1,0.8571,19,37,-18,22,11,11,2016-17
39,2017-01-21,Ottawa Senators,Home,SO Loss,2,3,-1,0.987,1.013,33,27,6,0.061,0.074,31,44,-13,0.4133,0.9259,0.9394,28,29,-1,19,14,5,2016-17
40,2017-01-19,New York Rangers,Home,Loss,2,5,-3,0.98,1.042,25,41,-16,0.08,0.122,28,35,-7,0.4444,0.9,0.92,21,34,-13,9,18,-9,2016-17
41,2017-01-17,Buffalo Sabres,Home,Win,4,3,1,1.014,0.986,32,27,5,0.125,0.111,32,20,12,0.6154,0.8889,0.875,26,41,-15,9,17,-8,2016-17
42,2017-01-14,Ottawa Senators,Away,Win,4,2,2,1.094,0.906,27,37,-10,0.148,0.054,28,43,-15,0.3944,0.9459,0.8519,30,38,-8,21,15,6,2016-17
43,2017-01-13,New York Rangers,Away,Win,4,2,2,1.093,0.907,27,36,-9,0.148,0.056,35,22,13,0.614,0.9444,0.8519,21,13,8,14,16,-2,2016-17
44,2017-01-07,Montreal Canadiens,Home,Loss,3,5,-2,0.922,1.078,36,31,5,0.083,0.161,34,27,7,0.5574,0.8387,0.9167,19,25,-6,4,23,-19,2016-17
45,2017-01-06,New Jersey Devils,Away,Win,4,2,2,1.223,0.777,14,32,-18,0.286,0.063,22,32,-10,0.4074,0.9375,0.7143,13,9,4,4,13,-9,2016-17
46,2017-01-03,Washington Capitals,Away,OT Loss,5,6,-1,0.993,1.007,25,29,-4,0.2,0.207,28,36,-8,0.4375,0.7931,0.8,23,33,-10,16,13,3,2016-17
47,2017-01-01,Detroit Red Wings,Home,OT Win,5,4,1,1.07,0.93,28,37,-9,0.179,0.108,37,38,-1,0.4933,0.8919,0.8214,31,46,-15,15,13,2,2016-17
48,2016-12-29,Tampa Bay Lightning,Away,OT Win,3,2,1,1.012,0.988,35,27,8,0.086,0.074,29,33,-4,0.4677,0.9259,0.9143,16,19,-3,18,12,6,2016-17
49,2016-12-28,Florida Panthers,Away,SO Win,3,2,1,1.007,0.993,40,47,-7,0.05,0.043,21,34,-13,0.3818,0.9574,0.95,15,25,-10,11,11,0,2016-17
50,2016-12-23,Arizona Coyotes,Away,Win,4,1,3,1.094,0.906,32,32,0,0.125,0.031,32,38,-6,0.4571,0.9688,0.875,19,29,-10,23,14,9,2016-17
51,2016-12-22,Colorado Avalanche,Away,Win,6,0,6,1.194,0.806,31,38,-7,0.194,0,25,38,-13,0.3968,1,0.8065,11,29,-18,13,12,1,2016-17
52,2016-12-19,Anaheim Ducks,Home,Loss,2,3,-1,0.95,1.05,35,28,7,0.057,0.107,21,42,-21,0.3333,0.8929,0.9429,24,37,-13,15,16,-1,2016-17
53,2016-12-17,Pittsburgh Penguins,Home,OT Win,2,1,1,1.011,0.989,49,34,15,0.041,0.029,30,22,8,0.5769,0.9706,0.9592,38,42,-4,18,21,-3,2016-17
54,2016-12-15,Arizona Coyotes,Home,SO Loss,2,3,-1,0.977,1.023,46,30,16,0.043,0.067,35,24,11,0.5932,0.9333,0.9565,29,33,-4,13,23,-10,2016-17
55,2016-12-13,San Jose Sharks,Home,SO Loss,2,3,-1,1.017,0.983,31,42,-11,0.065,0.048,43,26,17,0.6232,0.9524,0.9355,20,23,-3,21,9,12,2016-17
56,2016-12-11,Colorado Avalanche,Home,Loss,1,3,-2,0.948,1.084,52,29,23,0.019,0.103,31,35,-4,0.4697,0.9286,0.9808,32,42,-10,9,22,-13,2016-17
57,2016-12-10,Boston Bruins,Away,Win,4,1,3,1.17,0.872,20,33,-13,0.2,0.03,24,29,-5,0.4528,0.9697,0.8421,24,27,-3,22,6,16,2016-17
58,2016-12-07,Minnesota Wild,Home,Loss,2,3,-1,0.904,1.096,37,20,17,0.054,0.15,35,29,6,0.5469,0.85,0.9459,33,31,2,12,24,-12,2016-17
59,2016-12-03,Vancouver Canucks,Away,SO Loss,2,3,-1,0.967,1.033,40,24,16,0.05,0.083,28,36,-8,0.4375,0.9167,0.95,24,25,-1,7,8,-1,2016-17
60,2016-11-30,Calgary Flames,Away,Loss,0,3,-3,0.897,1.103,39,29,10,0,0.103,21,29,-8,0.42,0.8966,1,18,11,7,7,13,-6,2016-17
61,2016-11-29,Edmonton Oilers,Away,Win,4,2,2,1.107,0.893,23,30,-7,0.174,0.067,30,29,1,0.5085,0.9333,0.8261,14,34,-20,31,16,15,2016-17
62,2016-11-26,Washington Capitals,Home,Win,4,2,2,1.051,0.949,37,35,2,0.108,0.057,26,41,-15,0.3881,0.9429,0.8919,23,26,-3,17,9,8,2016-17
63,2016-11-23,New Jersey Devils,Away,SO Loss,4,5,-1,0.996,1.004,31,30,1,0.129,0.133,32,36,-4,0.4706,0.8667,0.871,9,19,-10,10,9,1,2016-17
64,2016-11-22,Carolina Hurricanes,Home,Loss,1,2,-1,0.969,1.031,26,29,-3,0.038,0.069,24,24,0,0.5,0.931,0.9615,30,30,0,18,15,3,2016-17
65,2016-11-19,Montreal Canadiens,Away,Loss,1,2,-1,0.962,1.038,32,29,3,0.031,0.069,28,31,-3,0.4746,0.931,0.9688,37,33,4,13,27,-14,2016-17
66,2016-11-17,Florida Panthers,Home,Win,6,1,5,1.163,0.837,30,27,3,0.2,0.037,28,29,-1,0.4912,0.963,0.8,19,35,-16,18,7,11,2016-17
67,2016-11-15,Nashville Predators,Home,Win,6,2,4,1.129,0.871,32,34,-2,0.188,0.059,29,28,1,0.5088,0.9412,0.8125,20,33,-13,12,10,2,2016-17
68,2016-11-12,Pittsburgh Penguins,Away,Loss,1,4,-3,0.946,1.054,36,49,-13,0.028,0.082,24,30,-6,0.4444,0.9184,0.9722,34,26,8,11,16,-5,2016-17
69,2016-11-11,Philadelphia Flyers,Home,Win,6,3,3,1.17,0.83,23,33,-10,0.261,0.091,32,23,9,0.5818,0.9091,0.7391,29,31,-2,13,24,-11,2016-17
70,2016-11-08,Los Angeles Kings,Home,Loss,0,7,-7,0.837,1.163,19,43,-24,0,0.163,28,29,-1,0.4912,0.8372,1,39,39,0,18,10,8,2016-17
71,2016-11-05,Vancouver Canucks,Home,Win,6,3,3,1.039,0.961,42,29,13,0.143,0.103,42,27,15,0.6087,0.8966,0.8571,32,24,8,13,16,-3,2016-17
72,2016-11-03,Buffalo Sabres,Away,Win,2,1,1,1.046,0.954,29,43,-14,0.069,0.023,26,44,-18,0.3714,0.9767,0.931,28,24,4,17,8,9,2016-17
73,2016-11-01,Edmonton Oilers,Home,OT Win,3,2,1,1.053,0.947,31,46,-15,0.097,0.043,27,28,-1,0.4909,0.9565,0.9032,34,32,2,14,16,-2,2016-17
74,2016-10-30,New York Islanders,Away,Loss,1,5,-4,0.887,1.113,34,35,-1,0.029,0.143,33,30,3,0.5238,0.8571,0.9706,23,19,4,7,22,-15,2016-17
75,2016-10-29,Montreal Canadiens,Away,Loss,1,2,-1,0.962,1.038,38,31,7,0.026,0.065,24,30,-6,0.4444,0.9355,0.9737,45,20,25,19,26,-7,2016-17
76,2016-10-27,Florida Panthers,Home,Win,3,2,1,1.043,0.957,28,31,-3,0.107,0.065,30,27,3,0.5263,0.9355,0.8929,19,29,-10,14,13,1,2016-17
77,2016-10-25,Tampa Bay Lightning,Home,Loss,3,7,-4,0.778,1.222,43,24,19,0.07,0.292,51,28,23,0.6456,0.7083,0.9302,26,22,4,9,13,-4,2016-17
78,2016-10-22,Chicago Blackhawks,Away,SO Loss,4,5,-1,1.003,0.997,34,35,-1,0.118,0.114,35,40,-5,0.4667,0.8857,0.8824,27,12,15,24,11,13,2016-17
79,2016-10-20,Minnesota Wild,Away,Loss,2,3,-1,0.949,1.051,33,27,6,0.061,0.111,20,33,-13,0.3774,0.8889,0.9394,12,16,-4,20,13,7,2016-17
80,2016-10-19,Winnipeg Jets,Away,OT Loss,4,5,-1,0.953,1.047,40,34,6,0.1,0.147,28,36,-8,0.4375,0.8529,0.9,17,23,-6,27,16,11,2016-17
81,2016-10-15,Boston Bruins,Home,Win,4,1,3,1.127,0.873,24,25,-1,0.167,0.04,32,20,12,0.6154,0.96,0.8333,28,24,4,18,13,5,2016-17
82,2016-10-12,Ottawa Senators,Away,OT Loss,4,5,-1,0.939,1.061,38,30,8,0.105,0.167,34,32,2,0.5152,0.8333,0.8947,21,30,-9,9,25,-16,2016-17
1,2018-04-07,Montreal Canadiens,Home,Win,4,2,2,1.073,0.927,30,33,-3,0.133,0.061,37,23,14,0.6167,0.9394,0.8667,16,18,-2,13,21,-8,2017-18
2,2018-04-05,New Jersey Devils,Away,Loss,1,2,-1,0.98,1.02,32,39,-7,0.031,0.051,33,29,4,0.5323,0.9487,0.9688,17,14,3,9,12,-3,2017-18
3,2018-04-02,Buffalo Sabres,Home,Win,5,2,3,1.08,0.92,36,34,2,0.139,0.059,35,27,8,0.5645,0.9412,0.8611,32,23,9,15,12,3,2017-18
4,2018-03-31,Winnipeg Jets,Home,Loss,1,3,-2,0.931,1.069,29,29,0,0.034,0.103,36,24,12,0.6,0.8966,0.9655,11,26,-15,7,14,-7,2017-18
5,2018-03-30,New York Islanders,Away,Win,5,4,1,1.035,0.965,32,33,-1,0.156,0.121,30,25,5,0.5455,0.8788,0.8438,13,14,-1,8,21,-13,2017-18
6,2018-03-28,Florida Panthers,Home,Win,4,3,1,1.023,0.977,35,33,2,0.114,0.091,35,36,-1,0.493,0.9091,0.8857,22,24,-2,22,18,4,2017-18
7,2018-03-26,Buffalo Sabres,Home,Loss,2,3,-1,0.938,1.062,41,27,14,0.049,0.111,26,22,4,0.5417,0.8889,0.9512,21,29,-8,8,19,-11,2017-18
8,2018-03-24,Detroit Red Wings,Home,Win,4,3,1,1.065,0.935,29,41,-12,0.138,0.073,37,33,4,0.5286,0.9268,0.8621,13,19,-6,11,19,-8,2017-18
9,2018-03-22,Nashville Predators,Away,Win,5,2,3,1.099,0.901,28,25,3,0.179,0.08,29,35,-6,0.4531,0.92,0.8214,12,17,-5,13,14,-1,2017-18
10,2018-03-20,Tampa Bay Lightning,Away,Loss,3,4,-1,0.94,1.06,30,25,5,0.1,0.16,29,29,0,0.5,0.84,0.9,20,28,-8,10,15,-5,2017-18
11,2018-03-17,Montreal Canadiens,Home,Win,4,0,4,1.082,0.918,49,33,16,0.082,0,33,30,3,0.5238,1,0.9184,16,37,-21,19,18,1,2017-18
12,2018-03-15,Buffalo Sabres,Away,Win,5,2,3,1.078,0.945,39,40,-1,0.128,0.05,28,30,-2,0.4828,0.95,0.8947,16,18,-2,18,9,9,2017-18
13,2018-03-14,Dallas Stars,Home,SO Win,6,5,1,1.009,0.991,33,35,-2,0.152,0.143,39,36,3,0.52,0.8571,0.8485,20,39,-19,14,17,-3,2017-18
14,2018-03-10,Pittsburgh Penguins,Home,Win,5,2,3,1.142,0.89,26,40,-14,0.192,0.05,38,31,7,0.5507,0.95,0.84,19,25,-6,17,12,5,2017-18
15,2018-03-05,Buffalo Sabres,Away,Loss,3,5,-2,0.865,1.135,41,24,17,0.073,0.208,28,37,-9,0.4308,0.7917,0.9268,23,20,3,5,13,-8,2017-18
16,2018-03-03,Washington Capitals,Away,Loss,2,5,-3,0.922,1.078,29,34,-5,0.069,0.147,29,38,-9,0.4328,0.8529,0.931,26,22,4,11,24,-13,2017-18
17,2018-02-27,Florida Panthers,Away,OT Loss,2,3,-1,0.955,1.045,39,31,8,0.051,0.097,32,29,3,0.5246,0.9032,0.9487,11,18,-7,7,15,-8,2017-18
18,2018-02-26,Tampa Bay Lightning,Away,SO Loss,3,4,-1,1.029,0.971,30,42,-12,0.1,0.071,33,32,1,0.5077,0.9286,0.9,24,21,3,14,13,1,2017-18
19,2018-02-24,Boston Bruins,Home,Win,4,3,1,0.984,1.019,35,23,12,0.114,0.13,30,29,1,0.5085,0.8696,0.8889,23,29,-6,11,22,-11,2017-18
20,2018-02-22,New York Islanders,Home,SO Win,4,3,1,1.011,0.989,31,35,-4,0.097,0.086,34,29,5,0.5397,0.9143,0.9032,18,30,-12,14,19,-5,2017-18
21,2018-02-20,Florida Panthers,Home,Win,1,0,1,1.032,0.968,31,40,-9,0.032,0,40,20,20,0.6667,1,0.9677,20,20,0,14,12,2,2017-18
22,2018-02-18,Detroit Red Wings,Away,Win,3,2,1,1.019,0.981,34,29,5,0.088,0.069,32,29,3,0.5246,0.931,0.9118,16,29,-13,6,13,-7,2017-18
23,2018-02-17,Pittsburgh Penguins,Away,Loss,3,5,-2,0.966,1.034,32,39,-7,0.094,0.128,35,35,0,0.5,0.8718,0.9063,22,25,-3,13,13,0,2017-18
24,2018-02-14,Columbus Blue Jackets,Home,Win,6,3,3,1.162,0.867,28,57,-29,0.214,0.053,43,27,16,0.6143,0.9474,0.8148,18,17,1,14,15,-1,2017-18
25,2018-02-12,Tampa Bay Lightning,Home,Win,4,3,1,1.086,0.914,23,34,-11,0.174,0.088,29,31,-2,0.4833,0.9118,0.8261,20,27,-7,15,11,4,2017-18
26,2018-02-10,Ottawa Senators,Home,Win,6,3,3,1.026,0.995,41,25,16,0.146,0.12,31,28,3,0.5254,0.88,0.875,21,37,-16,13,17,-4,2017-18
27,2018-02-07,Nashville Predators,Home,SO Win,3,2,1,1.019,0.981,32,46,-14,0.063,0.043,29,44,-15,0.3973,0.9565,0.9375,29,23,6,13,11,2,2017-18
28,2018-02-05,Anaheim Ducks,Home,Win,7,4,3,1.084,0.937,40,44,-4,0.175,0.091,38,33,5,0.5352,0.9091,0.8462,10,26,-16,23,12,11,2017-18
29,2018-02-03,Boston Bruins,Away,Loss,1,4,-3,0.938,1.092,24,30,-6,0.042,0.133,33,27,6,0.55,0.8966,0.9583,29,26,3,15,9,6,2017-18
30,2018-02-01,New York Rangers,Away,Win,4,0,4,1.125,0.875,32,25,7,0.125,0,18,27,-9,0.4,1,0.875,10,23,-13,6,20,-14,2017-18
31,2018-01-31,New York Islanders,Home,Win,5,0,5,1.1,0.9,50,28,22,0.1,0,39,28,11,0.5821,1,0.9,19,39,-20,20,16,4,2017-18
32,2018-01-25,Dallas Stars,Away,Win,4,1,3,1.113,0.887,29,40,-11,0.138,0.025,31,33,-2,0.4844,0.975,0.8621,17,15,2,15,15,0,2017-18
33,2018-01-24,Chicago Blackhawks,Away,OT Win,3,2,1,1.028,0.972,36,36,0,0.083,0.056,33,35,-2,0.4853,0.9444,0.9167,25,17,8,20,15,5,2017-18
34,2018-01-22,Colorado Avalanche,Home,Loss,2,4,-2,0.949,1.084,31,27,4,0.065,0.148,40,23,17,0.6349,0.8846,0.9355,26,26,0,4,16,-12,2017-18
35,2018-01-20,Ottawa Senators,Away,Win,4,3,1,0.955,1.045,33,18,15,0.121,0.167,36,34,2,0.5143,0.8333,0.8788,25,29,-4,25,16,9,2017-18
36,2018-01-18,Philadelphia Flyers,Away,OT Loss,2,3,-1,0.983,1.017,31,37,-6,0.065,0.081,28,36,-8,0.4375,0.9189,0.9355,19,25,-6,15,19,-4,2017-18
37,2018-01-16,St. Louis Blues,Home,OT Loss,1,2,-1,0.985,1.015,31,42,-11,0.032,0.048,34,23,11,0.5965,0.9524,0.9677,25,32,-7,14,22,-8,2017-18
38,2018-01-10,Ottawa Senators,Home,Loss,3,4,-1,0.938,1.063,48,32,16,0.063,0.125,45,30,15,0.6,0.875,0.9375,11,21,-10,8,20,-12,2017-18
39,2018-01-08,Columbus Blue Jackets,Home,OT Loss,2,3,-1,0.963,1.037,37,33,4,0.054,0.091,29,28,1,0.5088,0.9091,0.9459,15,27,-12,14,15,-1,2017-18
40,2018-01-06,Vancouver Canucks,Home,SO Win,3,2,1,1,1,36,36,0,0.056,0.056,45,26,19,0.6338,0.9444,0.9444,20,37,-17,5,21,-16,2017-18
41,2018-01-04,San Jose Sharks,Home,SO Win,3,2,1,1.014,0.986,28,35,-7,0.071,0.057,33,35,-2,0.4853,0.9429,0.9286,16,30,-14,12,13,-1,2017-18
42,2018-01-02,Tampa Bay Lightning,Home,Loss,0,2,-2,0.944,1.056,29,36,-7,0,0.056,29,23,6,0.5577,0.9444,1,16,17,-1,14,15,-1,2017-18
43,2017-12-31,Vegas Golden Knights,Away,Loss,3,6,-3,0.964,1.063,23,31,-8,0.13,0.194,29,25,4,0.537,0.8333,0.8696,21,20,1,15,18,-3,2017-18
44,2017-12-29,Colorado Avalanche,Away,OT Loss,3,4,-1,0.945,1.055,34,28,6,0.088,0.143,44,26,18,0.6286,0.8571,0.9118,21,17,4,14,17,-3,2017-18
45,2017-12-28,Arizona Coyotes,Away,Win,7,4,3,1.094,0.93,33,34,-1,0.212,0.118,38,37,1,0.5067,0.8824,0.8125,13,28,-15,21,7,14,2017-18
46,2017-12-23,New York Rangers,Away,Win,3,2,1,1.019,0.981,37,32,5,0.081,0.063,25,48,-23,0.3425,0.9375,0.9189,9,11,-2,14,16,-2,2017-18
47,2017-12-20,Columbus Blue Jackets,Away,Loss,2,4,-2,0.941,1.059,41,37,4,0.049,0.108,32,28,4,0.5333,0.8919,0.9512,25,25,0,8,13,-5,2017-18
48,2017-12-19,Carolina Hurricanes,Home,Win,8,1,7,1.192,0.808,36,33,3,0.222,0.03,27,38,-11,0.4154,0.9697,0.7778,13,22,-9,21,10,11,2017-18
49,2017-12-15,Detroit Red Wings,Away,Loss,1,3,-2,0.935,1.065,26,29,-3,0.038,0.103,28,30,-2,0.4828,0.8966,0.9615,17,20,-3,6,14,-8,2017-18
50,2017-12-14,Minnesota Wild,Away,Loss,0,2,-2,0.923,1.077,28,26,2,0,0.077,33,29,4,0.5323,0.9231,1,17,12,5,8,21,-13,2017-18
51,2017-12-12,Philadelphia Flyers,Away,Loss,2,4,-2,1.012,1.012,22,39,-17,0.091,0.103,24,31,-7,0.4364,0.9211,0.9091,18,22,-4,12,11,1,2017-18
52,2017-12-10,Edmonton Oilers,Home,Win,1,0,1,1.043,0.957,23,41,-18,0.043,0,22,19,3,0.5366,1,0.9565,14,29,-15,20,14,6,2017-18
53,2017-12-09,Pittsburgh Penguins,Away,Win,4,3,1,1.077,0.923,25,36,-11,0.16,0.083,29,31,-2,0.4833,0.9167,0.84,28,39,-11,23,10,13,2017-18
54,2017-12-06,Calgary Flames,Home,SO Win,2,1,1,1.014,0.986,29,48,-19,0.034,0.021,39,30,9,0.5652,0.9792,0.9655,15,23,-8,12,24,-12,2017-18
55,2017-12-02,Vancouver Canucks,Away,Loss,1,2,-1,0.951,1.049,36,26,10,0.028,0.077,34,24,10,0.5862,0.9231,0.9722,15,16,-1,10,19,-9,2017-18
56,2017-11-30,Edmonton Oilers,Away,Win,6,4,2,1.078,0.946,36,45,-9,0.167,0.089,36,36,0,0.5,0.9111,0.8571,26,31,-5,18,16,2,2017-18
57,2017-11-28,Calgary Flames,Away,Win,4,1,3,1.083,0.947,30,20,10,0.133,0.05,29,33,-4,0.4677,0.95,0.8966,8,11,-3,17,21,-4,2017-18
58,2017-11-25,Washington Capitals,Home,Loss,2,4,-2,0.919,1.122,29,21,8,0.069,0.19,34,25,9,0.5763,0.85,0.931,26,37,-11,12,12,0,2017-18
59,2017-11-24,Carolina Hurricanes,Away,Win,5,4,1,1.115,0.885,25,47,-22,0.2,0.085,24,29,-5,0.4528,0.9149,0.8,27,33,-6,22,7,15,2017-18
60,2017-11-22,Florida Panthers,Away,SO Loss,1,2,-1,0.999,1.001,44,43,1,0.023,0.023,38,30,8,0.5588,0.9767,0.9773,14,13,1,6,18,-12,2017-18
61,2017-11-20,Arizona Coyotes,Home,Loss,1,4,-3,0.967,1.093,28,31,-3,0.036,0.129,26,33,-7,0.4407,0.931,0.9643,15,21,-6,9,17,-8,2017-18
62,2017-11-18,Montreal Canadiens,Away,Win,6,0,6,1.194,0.806,31,33,-2,0.194,0,35,30,5,0.5385,1,0.8065,27,36,-9,19,15,4,2017-18
63,2017-11-16,New Jersey Devils,Home,OT Win,1,0,1,1.04,0.96,25,42,-17,0.04,0,38,31,7,0.5507,1,0.96,29,22,7,15,19,-4,2017-18
64,2017-11-11,Boston Bruins,Away,Win,4,1,3,1.134,0.901,25,39,-14,0.16,0.026,28,34,-6,0.4516,0.9744,0.875,29,30,-1,11,16,-5,2017-18
65,2017-11-10,Boston Bruins,Home,OT Win,3,2,1,1.034,0.966,33,35,-2,0.091,0.057,33,33,0,0.5,0.9429,0.9091,25,23,2,15,17,-2,2017-18
66,2017-11-08,Minnesota Wild,Home,Win,4,2,2,1.156,0.887,19,37,-18,0.211,0.054,22,31,-9,0.4151,0.9459,0.8333,18,27,-9,18,15,3,2017-18
67,2017-11-06,Vegas Golden Knights,Home,SO Win,4,3,1,1.013,0.987,25,28,-3,0.12,0.107,29,30,-1,0.4915,0.8929,0.88,29,31,-2,12,19,-7,2017-18
68,2017-11-04,St. Louis Blues,Away,Loss,4,6,-2,0.942,1.058,31,32,-1,0.129,0.188,30,36,-6,0.4545,0.8125,0.871,11,19,-8,20,11,9,2017-18
69,2017-11-02,Los Angeles Kings,Away,Loss,3,5,-2,0.905,1.095,36,28,8,0.083,0.179,35,31,4,0.5303,0.8214,0.9167,25,19,6,6,19,-13,2017-18
70,2017-11-01,Anaheim Ducks,Away,Win,3,1,2,1.069,0.931,29,29,0,0.103,0.034,26,34,-8,0.4333,0.9655,0.8966,20,27,-7,14,15,-1,2017-18
71,2017-10-30,San Jose Sharks,Away,Loss,2,3,-1,1.058,0.966,18,39,-21,0.111,0.077,29,35,-6,0.4531,0.9474,0.8889,18,13,5,21,25,-4,2017-18
72,2017-10-28,Philadelphia Flyers,Home,Loss,2,4,-2,0.933,1.067,30,30,0,0.067,0.133,34,31,3,0.5231,0.8667,0.9333,29,32,-3,8,15,-7,2017-18
73,2017-10-26,Carolina Hurricanes,Home,Loss,3,6,-3,0.93,1.07,34,38,-4,0.088,0.158,29,33,-4,0.4677,0.8421,0.9118,16,11,5,16,14,2,2017-18
74,2017-10-23,Los Angeles Kings,Home,Win,3,2,1,1.036,0.964,34,38,-4,0.088,0.053,34,29,5,0.5397,0.9474,0.9118,29,28,1,12,13,-1,2017-18
75,2017-10-21,Ottawa Senators,Away,Loss,3,6,-3,0.95,1.075,31,35,-4,0.097,0.171,35,42,-7,0.4545,0.8529,0.9032,24,16,8,11,23,-12,2017-18
76,2017-10-18,Detroit Red Wings,Home,Win,6,3,3,1.14,0.891,26,33,-7,0.231,0.091,36,24,12,0.6,0.9091,0.8,21,30,-9,12,4,8,2017-18
77,2017-10-17,Washington Capitals,Away,Win,2,0,2,1.067,0.966,30,30,0,0.067,0,23,28,-5,0.451,1,0.9655,24,24,0,17,9,8,2017-18
78,2017-10-14,Montreal Canadiens,Away,OT Win,4,3,1,1.094,0.906,22,34,-12,0.182,0.088,37,28,9,0.5692,0.9118,0.8182,33,21,12,14,27,-13,2017-18
79,2017-10-11,New Jersey Devils,Home,Loss,3,6,-3,0.866,1.134,50,31,19,0.06,0.194,43,34,9,0.5584,0.8065,0.94,19,22,-3,8,18,-10,2017-18
80,2017-10-09,Chicago Blackhawks,Home,OT Win,4,3,1,0.95,1.05,43,21,22,0.093,0.143,39,25,14,0.6094,0.8571,0.907,25,15,10,12,15,-3,2017-18
81,2017-10-07,New York Rangers,Home,Win,8,5,3,1.052,0.948,41,35,6,0.195,0.143,46,31,15,0.5974,0.8571,0.8049,21,20,1,7,18,-11,2017-18
82,2017-10-04,Winnipeg Jets,Away,Win,7,2,5,1.172,0.828,31,37,-6,0.226,0.054,35,28,7,0.5556,0.9459,0.7742,16,18,-2,24,14,10,2017-18
1,2019-04-06,Montreal Canadiens,Away,SO Loss,5,6,-1,1,1,49,49,0,0.102,0.102,34,44,-10,0.4359,0.898,0.898,8,25,-17,11,21,-10,2018-19
2,2019-04-04,Tampa Bay Lightning,Home,Loss,1,3,-2,0.962,1.07,30,29,1,0.033,0.103,20,24,-4,0.4545,0.9286,0.9667,26,28,-2,10,14,-4,2018-19
3,2019-04-02,Carolina Hurricanes,Home,Loss,1,4,-3,0.958,1.066,24,37,-13,0.042,0.108,36,25,11,0.5902,0.9167,0.9583,22,23,-1,15,16,-1,2018-19
4,2019-04-01,New York Islanders,Away,Win,2,1,1,1.018,0.982,38,29,9,0.053,0.034,33,29,4,0.5323,0.9655,0.9474,21,25,-4,19,11,8,2018-19
5,2019-03-30,Ottawa Senators,Away,Loss,2,4,-2,0.903,1.136,44,22,22,0.045,0.182,33,20,13,0.6226,0.8571,0.9545,29,26,3,13,23,-10,2018-19
6,2019-03-27,Philadelphia Flyers,Away,SO Loss,4,5,-1,1.004,0.996,42,44,-2,0.095,0.091,31,28,3,0.5254,0.9091,0.9048,20,20,0,9,17,-8,2018-19
7,2019-03-25,Florida Panthers,Home,Win,7,5,2,1.05,0.95,37,36,1,0.189,0.139,36,29,7,0.5538,0.8611,0.8108,25,21,4,15,17,-2,2018-19
8,2019-03-23,New York Rangers,Home,OT Loss,1,2,-1,0.951,1.049,45,28,17,0.022,0.071,38,25,13,0.6032,0.9286,0.9778,16,28,-12,13,33,-20,2018-19
9,2019-03-20,Buffalo Sabres,Away,Win,4,2,2,1.004,1.017,46,24,22,0.087,0.083,36,30,6,0.5455,0.9167,0.9333,7,26,-19,10,14,-4,2018-19
10,2019-03-19,Nashville Predators,Away,Loss,0,3,-3,0.895,1.15,22,20,2,0,0.15,21,26,-5,0.4468,0.8947,1,11,18,-7,11,18,-7,2018-19
11,2019-03-16,Ottawa Senators,Away,Loss,2,6,-4,0.918,1.082,37,44,-7,0.054,0.136,35,23,12,0.6034,0.8636,0.9459,29,25,4,12,22,-10,2018-19
12,2019-03-15,Philadelphia Flyers,Home,Win,7,6,1,0.93,1.07,51,29,22,0.137,0.207,41,31,10,0.5694,0.7931,0.8627,11,13,-2,8,26,-18,2018-19
13,2019-03-13,Chicago Blackhawks,Home,Loss,4,5,-1,0.957,1.043,47,39,8,0.085,0.128,33,26,7,0.5593,0.8718,0.9149,15,10,5,9,28,-19,2018-19
14,2019-03-11,Tampa Bay Lightning,Home,Loss,2,6,-4,0.929,1.071,28,42,-14,0.071,0.143,35,29,6,0.5469,0.8571,0.9286,14,20,-6,7,8,-1,2018-19
15,2019-03-09,Edmonton Oilers,Away,Win,3,2,1,1.014,0.986,40,33,7,0.075,0.061,30,21,9,0.5882,0.9394,0.925,21,23,-2,12,15,-3,2018-19
16,2019-03-06,Vancouver Canucks,Away,OT Loss,2,3,-1,0.97,1.03,30,31,-1,0.067,0.097,28,37,-9,0.4308,0.9032,0.9333,14,22,-8,24,19,5,2018-19
17,2019-03-04,Calgary Flames,Away,Win,6,2,4,1.133,0.867,32,37,-5,0.188,0.054,33,31,2,0.5156,0.9459,0.8125,13,15,-2,20,16,4,2018-19
18,2019-03-02,Buffalo Sabres,Home,Win,5,2,3,1.102,0.925,32,37,-5,0.156,0.054,28,16,12,0.6364,0.9459,0.871,27,27,0,13,17,-4,2018-19
19,2019-02-28,New York Islanders,Away,Loss,1,6,-5,0.866,1.134,35,37,-2,0.029,0.162,21,27,-6,0.4375,0.8378,0.9714,22,39,-17,7,17,-10,2018-19
20,2019-02-27,Edmonton Oilers,Home,Win,6,2,4,1.111,0.889,36,36,0,0.167,0.056,37,22,15,0.6271,0.9444,0.8333,17,33,-16,14,17,-3,2018-19
21,2019-02-25,Buffalo Sabres,Home,Win,5,3,2,1.063,0.937,33,34,-1,0.152,0.088,31,26,5,0.5439,0.9118,0.8485,29,35,-6,20,15,5,2018-19
22,2019-02-23,Montreal Canadiens,Home,Win,6,3,3,1.081,0.971,36,35,1,0.167,0.086,31,38,-7,0.4493,0.9143,0.8857,15,27,-12,20,19,1,2018-19
23,2019-02-21,Washington Capitals,Home,Loss,2,3,-1,0.94,1.06,42,28,14,0.048,0.107,36,17,19,0.6792,0.8929,0.9524,17,35,-18,12,21,-9,2018-19
24,2019-02-19,St. Louis Blues,Away,OT Loss,2,3,-1,0.987,1.013,33,41,-8,0.061,0.073,37,34,3,0.5211,0.9268,0.9394,13,10,3,10,17,-7,2018-19
25,2019-02-16,Arizona Coyotes,Away,Loss,0,2,-2,0.931,1.069,22,29,-7,0,0.069,24,28,-4,0.4615,0.931,1,24,25,-1,17,27,-10,2018-19
26,2019-02-14,Vegas Golden Knights,Away,Win,6,3,3,1.049,0.951,43,33,10,0.14,0.091,32,36,-4,0.4706,0.9091,0.8605,18,38,-20,16,15,1,2018-19
27,2019-02-12,Colorado Avalanche,Away,Win,5,2,3,1.123,0.877,28,36,-8,0.179,0.056,26,30,-4,0.4643,0.9444,0.8214,20,19,1,20,11,9,2018-19
28,2019-02-10,New York Rangers,Away,Loss,1,4,-3,0.914,1.115,56,30,26,0.018,0.133,33,21,12,0.6111,0.8966,0.9821,14,29,-15,8,18,-10,2018-19
29,2019-02-09,Montreal Canadiens,Away,OT Win,4,3,1,1.046,0.954,32,38,-6,0.125,0.079,32,25,7,0.5614,0.9211,0.875,16,49,-33,27,14,13,2018-19
30,2019-02-06,Ottawa Senators,Home,Win,5,4,1,1.076,0.924,30,44,-14,0.167,0.091,22,32,-10,0.4074,0.9091,0.8333,13,27,-14,13,21,-8,2018-19
31,2019-02-04,Anaheim Ducks,Home,Win,6,1,5,1.096,0.904,44,25,19,0.136,0.04,40,28,12,0.5882,0.96,0.8636,11,36,-25,11,20,-9,2018-19
32,2019-02-02,Pittsburgh Penguins,Home,Win,3,2,1,1.024,0.976,33,30,3,0.091,0.067,35,25,10,0.5833,0.9333,0.9091,22,29,-7,19,22,-3,2018-19
33,2019-02-01,Detroit Red Wings,Away,OT Loss,2,3,-1,1.004,0.996,21,33,-12,0.095,0.091,25,28,-3,0.4717,0.9091,0.9048,13,16,-3,8,13,-5,2018-19
34,2019-01-23,Washington Capitals,Home,Win,6,3,3,1.094,0.929,37,44,-7,0.162,0.068,38,21,17,0.6441,0.9318,0.8611,15,32,-17,9,22,-13,2018-19
35,2019-01-20,Arizona Coyotes,Home,Loss,2,4,-2,0.977,1.052,26,31,-5,0.077,0.129,31,19,12,0.62,0.9,0.9231,19,24,-5,11,30,-19,2018-19
36,2019-01-18,Florida Panthers,Away,Loss,1,3,-2,0.976,1.056,21,29,-8,0.048,0.103,35,29,6,0.5469,0.9286,0.9524,21,26,-5,8,11,-3,2018-19
37,2019-01-17,Tampa Bay Lightning,Away,Win,4,2,2,1.076,0.953,31,38,-7,0.129,0.053,31,39,-8,0.4429,0.9474,0.9,17,30,-13,21,8,13,2018-19
38,2019-01-14,Colorado Avalanche,Home,Loss,3,6,-3,1.039,1.008,20,38,-18,0.15,0.158,33,21,12,0.6111,0.8889,0.85,13,25,-12,14,14,0,2018-19
39,2019-01-12,Boston Bruins,Home,Loss,2,3,-1,0.959,1.041,32,29,3,0.063,0.103,30,28,2,0.5172,0.8966,0.9375,28,29,-1,11,20,-9,2018-19
40,2019-01-10,New Jersey Devils,Away,Win,4,2,2,1.024,0.998,43,29,14,0.093,0.069,37,41,-4,0.4744,0.931,0.9286,9,15,-6,8,9,-1,2018-19
41,2019-01-07,Nashville Predators,Home,Loss,0,4,-4,0.875,1.125,18,32,-14,0,0.125,21,25,-4,0.4565,0.875,1,18,31,-13,15,23,-8,2018-19
42,2019-01-05,Vancouver Canucks,Home,Win,5,0,5,1.147,0.853,34,28,6,0.147,0,34,22,12,0.6071,1,0.8529,21,26,-5,18,19,-1,2018-19
43,2019-01-03,Minnesota Wild,Home,Loss,3,4,-1,0.956,1.044,41,34,7,0.073,0.118,43,26,17,0.6232,0.8824,0.9268,17,16,1,13,18,-5,2018-19
44,2018-12-29,New York Islanders,Home,Loss,0,4,-4,0.857,1.143,36,28,8,0,0.143,37,26,11,0.5873,0.8571,1,15,23,-8,11,19,-8,2018-19
45,2018-12-28,Columbus Blue Jackets,Away,Win,4,2,2,1.069,0.931,29,29,0,0.138,0.069,36,26,10,0.5806,0.931,0.8621,8,24,-16,17,12,5,2018-19
46,2018-12-23,Detroit Red Wings,Home,OT Win,5,4,1,1.075,0.925,24,30,-6,0.208,0.133,26,28,-2,0.4815,0.8667,0.7917,13,29,-16,8,9,-1,2018-19
47,2018-12-22,New York Rangers,Home,Win,5,3,2,1.032,0.993,36,28,8,0.139,0.107,32,19,13,0.6275,0.8929,0.8857,13,27,-14,12,15,-3,2018-19
48,2018-12-20,Florida Panthers,Home,Win,6,1,5,1.192,0.808,26,26,0,0.231,0.038,29,28,1,0.5088,0.9615,0.7692,9,30,-21,13,22,-9,2018-19
49,2018-12-18,New Jersey Devils,Away,Win,7,2,5,1.157,0.843,31,29,2,0.226,0.069,29,32,-3,0.4754,0.931,0.7742,6,14,-8,9,6,3,2018-19
50,2018-12-15,Florida Panthers,Away,OT Loss,3,4,-1,0.973,1.027,32,33,-1,0.094,0.121,30,29,1,0.5085,0.8788,0.9063,12,24,-12,12,22,-10,2018-19
51,2018-12-13,Tampa Bay Lightning,Away,Loss,1,4,-3,0.83,1.17,49,21,28,0.02,0.19,43,36,7,0.5443,0.8095,0.9796,19,27,-8,16,23,-7,2018-19
52,2018-12-11,Carolina Hurricanes,Away,Win,4,1,3,1.105,0.895,29,30,-1,0.138,0.033,23,31,-8,0.4259,0.9667,0.8621,16,24,-8,19,17,2,2018-19
53,2018-12-08,Boston Bruins,Away,Loss,3,6,-3,0.906,1.094,32,32,0,0.094,0.188,36,32,4,0.5294,0.8125,0.9063,21,24,-3,8,13,-5,2018-19
54,2018-12-06,Detroit Red Wings,Home,OT Loss,4,5,-1,0.973,1.027,31,32,-1,0.129,0.156,38,27,11,0.5846,0.8438,0.871,14,21,-7,12,30,-18,2018-19
55,2018-12-04,Buffalo Sabres,Away,OT Win,4,3,1,1.06,0.94,30,41,-11,0.133,0.073,37,29,8,0.5606,0.9268,0.8667,11,14,-3,11,22,-11,2018-19
56,2018-12-01,Minnesota Wild,Away,Win,5,3,2,1.144,0.891,23,41,-18,0.217,0.073,33,29,4,0.5323,0.9268,0.8182,8,20,-12,16,12,4,2018-19
57,2018-11-28,San Jose Sharks,Home,Win,5,3,2,1.099,0.901,29,41,-12,0.172,0.073,42,28,14,0.6,0.9268,0.8276,15,17,-2,18,8,10,2018-19
58,2018-11-26,Boston Bruins,Home,Win,4,2,2,1.079,0.95,31,40,-9,0.129,0.05,33,25,8,0.569,0.95,0.9,23,19,4,22,17,5,2018-19
59,2018-11-24,Philadelphia Flyers,Home,Win,6,0,6,1.146,0.854,41,34,7,0.146,0,26,37,-11,0.4127,1,0.8537,4,27,-23,10,17,-7,2018-19
60,2018-11-23,Columbus Blue Jackets,Away,Loss,2,4,-2,0.892,1.108,34,24,10,0.059,0.167,24,28,-4,0.4615,0.8333,0.9412,13,21,-8,8,15,-7,2018-19
61,2018-11-21,Carolina Hurricanes,Away,Loss,2,5,-3,0.993,1.049,32,45,-13,0.063,0.111,36,28,8,0.5625,0.9302,0.9375,22,32,-10,12,15,-3,2018-19
62,2018-11-19,Columbus Blue Jackets,Home,Win,4,2,2,1.103,0.931,26,39,-13,0.154,0.051,38,27,11,0.5846,0.9487,0.88,17,24,-7,8,15,-7,2018-19
63,2018-11-16,Anaheim Ducks,Away,OT Win,2,1,1,1.032,0.968,35,39,-4,0.057,0.026,29,32,-3,0.4754,0.9744,0.9429,11,16,-5,18,19,-1,2018-19
64,2018-11-15,San Jose Sharks,Away,Win,5,3,2,1.08,0.92,34,45,-11,0.147,0.067,36,22,14,0.6207,0.9333,0.8529,19,32,-13,10,20,-10,2018-19
65,2018-11-13,Los Angeles Kings,Away,Win,5,1,4,1.099,0.901,35,23,12,0.143,0.043,27,29,-2,0.4821,0.9565,0.8571,8,12,-4,15,15,0,2018-19
66,2018-11-10,Boston Bruins,Away,Loss,1,5,-4,0.877,1.123,41,34,7,0.024,0.147,32,36,-4,0.4706,0.8529,0.9756,20,22,-2,12,12,0,2018-19
67,2018-11-09,New Jersey Devils,Home,Win,6,1,5,1.162,0.838,32,39,-7,0.188,0.026,35,23,12,0.6034,0.9744,0.8125,23,39,-16,16,16,0,2018-19
68,2018-11-06,Vegas Golden Knights,Home,Win,3,1,2,1.116,0.927,21,37,-16,0.143,0.027,36,23,13,0.6102,0.973,0.9,25,23,2,20,11,9,2018-19
69,2018-11-03,Pittsburgh Penguins,Away,Win,5,0,5,1.152,0.848,33,31,2,0.152,0,45,35,10,0.5625,1,0.8485,25,46,-21,12,13,-1,2018-19
70,2018-11-01,Dallas Stars,Home,Loss,1,2,-1,0.926,1.074,32,19,13,0.031,0.105,20,34,-14,0.3704,0.8947,0.9688,18,34,-16,9,13,-4,2018-19
71,2018-10-29,Calgary Flames,Home,Loss,1,3,-2,0.979,1.048,25,34,-9,0.04,0.088,32,33,-1,0.4923,0.9394,0.96,31,22,9,10,13,-3,2018-19
72,2018-10-27,Winnipeg Jets,Home,Win,3,2,1,1.013,0.987,31,24,7,0.097,0.083,29,32,-3,0.4754,0.9167,0.9032,20,27,-7,8,16,-8,2018-19
73,2018-10-24,Winnipeg Jets,Away,Win,4,2,2,1.053,0.947,39,40,-1,0.103,0.05,29,35,-6,0.4531,0.95,0.8974,8,21,-13,16,16,0,2018-19
74,2018-10-20,St. Louis Blues,Home,Loss,1,4,-3,0.918,1.117,23,25,-2,0.043,0.16,28,32,-4,0.4667,0.875,0.9565,22,33,-11,14,23,-9,2018-19
75,2018-10-18,Pittsburgh Penguins,Home,Loss,0,3,-3,0.973,1.079,38,38,0,0,0.079,31,25,6,0.5536,0.973,1,21,30,-9,7,22,-15,2018-19
76,2018-10-15,Los Angeles Kings,Home,Win,4,1,3,1.131,0.869,25,34,-9,0.16,0.029,29,31,-2,0.4833,0.9706,0.84,26,29,-3,21,21,0,2018-19
77,2018-10-13,Washington Capitals,Away,Win,4,2,2,1.069,0.931,28,27,1,0.143,0.074,23,26,-3,0.4694,0.9259,0.8571,14,28,-14,19,18,1,2018-19
78,2018-10-11,Detroit Red Wings,Away,Win,5,3,2,1.039,0.986,35,29,6,0.143,0.103,32,32,0,0.5,0.8966,0.8824,17,23,-6,11,7,4,2018-19
79,2018-10-09,Dallas Stars,Away,Win,7,4,3,1.116,0.911,30,34,-4,0.233,0.118,28,31,-3,0.4746,0.8824,0.7931,12,23,-11,11,15,-4,2018-19
80,2018-10-07,Chicago Blackhawks,Away,OT Win,7,6,1,1.012,0.988,34,31,3,0.206,0.194,30,30,0,0.5,0.8065,0.7941,23,23,0,29,14,15,2018-19
81,2018-10-06,Ottawa Senators,Home,Loss,3,5,-2,0.907,1.127,37,24,13,0.081,0.208,37,36,1,0.5068,0.8261,0.9189,30,26,4,8,27,-19,2018-19
82,2018-10-03,Montreal Canadiens,Home,OT Win,3,2,1,1.06,0.94,26,36,-10,0.115,0.056,37,26,11,0.5873,0.9444,0.8846,18,34,-16,24,16,8,2018-19
1,2020-02-20,Pittsburgh Penguins,Home,Win,4,0,4,1.133,0.867,30,24,6,0.133,0,33,20,13,0.6226,1,0.8667,18,22,-4,20,19,1,2019-20
2,2020-02-18,Pittsburgh Penguins,Away,Loss,2,5,-3,0.847,1.153,36,24,12,0.056,0.208,32,25,7,0.5614,0.7917,0.9444,25,28,-3,6,9,-3,2019-20
3,2020-02-16,Buffalo Sabres,Away,Loss,2,5,-3,0.952,1.048,22,36,-14,0.091,0.139,21,31,-10,0.4038,0.8611,0.9091,13,19,-6,13,13,0,2019-20
4,2020-02-15,Ottawa Senators,Away,Win,4,2,2,1.055,0.974,31,27,4,0.129,0.074,21,21,0,0.5,0.9259,0.9,28,42,-14,21,13,8,2019-20
5,2020-02-13,Dallas Stars,Home,Loss,2,3,-1,0.907,1.093,31,19,12,0.065,0.158,25,20,5,0.5556,0.8421,0.9355,12,27,-15,4,18,-14,2019-20
6,2020-02-11,Arizona Coyotes,Home,OT Win,3,2,1,1.019,0.981,41,37,4,0.073,0.054,32,25,7,0.5614,0.9459,0.9268,15,18,-3,17,17,0,2019-20
7,2020-02-08,Montreal Canadiens,Away,OT Loss,1,2,-1,0.977,1.023,23,30,-7,0.043,0.067,21,24,-3,0.4667,0.9333,0.9565,21,38,-17,19,17,2,2019-20
8,2020-02-07,Anaheim Ducks,Home,OT Win,5,4,1,1.01,0.99,35,30,5,0.143,0.133,34,30,4,0.5313,0.8667,0.8571,19,33,-14,21,10,11,2019-20
9,2020-02-05,New York Rangers,Away,Loss,3,5,-2,0.982,1.043,30,35,-5,0.1,0.143,31,31,0,0.5,0.8824,0.9,12,29,-17,8,21,-13,2019-20
10,2020-02-03,Florida Panthers,Home,Loss,3,5,-2,0.898,1.15,34,21,13,0.088,0.238,29,23,6,0.5577,0.8095,0.9118,10,30,-20,10,11,-1,2019-20
11,2020-02-01,Ottawa Senators,Home,OT Win,2,1,1,1.016,0.984,36,25,11,0.056,0.04,27,20,7,0.5745,0.96,0.9444,23,31,-8,8,19,-11,2019-20
12,2020-01-29,Dallas Stars,Away,Win,5,3,2,1.059,0.967,34,34,0,0.147,0.088,26,26,0,0.5,0.9118,0.8788,20,31,-11,23,15,8,2019-20
13,2020-01-27,Nashville Predators,Away,Win,5,2,3,1.106,0.922,31,36,-5,0.161,0.056,22,22,0,0.5,0.9444,0.8667,18,19,-1,13,11,2,2019-20
14,2020-01-18,Chicago Blackhawks,Home,Loss,2,6,-4,0.884,1.116,33,34,-1,0.061,0.176,28,18,10,0.6087,0.8235,0.9394,14,33,-19,10,13,-3,2019-20
15,2020-01-16,Calgary Flames,Home,SO Loss,1,2,-1,0.997,1.003,36,32,4,0.028,0.031,26,22,4,0.5417,0.9688,0.9722,18,22,-4,11,23,-12,2019-20
16,2020-01-14,New Jersey Devils,Home,Win,7,4,3,1.068,0.956,34,29,5,0.206,0.138,39,27,12,0.5909,0.8621,0.8182,17,20,-3,17,12,5,2019-20
17,2020-01-12,Florida Panthers,Away,Loss,4,8,-4,0.809,1.191,47,29,18,0.085,0.276,38,33,5,0.5352,0.7241,0.9149,6,18,-12,4,18,-14,2019-20
18,2020-01-08,Winnipeg Jets,Home,SO Loss,3,4,-1,1,1,28,28,0,0.107,0.107,18,19,-1,0.4865,0.8929,0.8929,9,25,-16,12,9,3,2019-20
19,2020-01-06,Edmonton Oilers,Home,Loss,4,6,-2,0.94,1.06,36,35,1,0.111,0.171,37,26,11,0.5873,0.8286,0.8889,21,33,-12,15,12,3,2019-20
20,2020-01-04,New York Islanders,Home,Win,3,0,3,1.13,0.909,23,33,-10,0.13,0,24,19,5,0.5581,1,0.9091,17,25,-8,9,13,-4,2019-20
21,2020-01-02,Winnipeg Jets,Away,Win,6,3,3,1.152,0.848,28,48,-20,0.214,0.063,30,30,0,0.5,0.9375,0.7857,10,24,-14,13,12,1,2019-20
22,2019-12-31,Minnesota Wild,Away,Win,4,1,3,1.101,0.93,29,27,2,0.138,0.037,31,34,-3,0.4769,0.963,0.8929,7,12,-5,17,9,8,2019-20
23,2019-12-28,New York Rangers,Home,OT Loss,4,5,-1,0.952,1.048,48,38,10,0.083,0.132,47,22,25,0.6812,0.8684,0.9167,12,30,-18,9,21,-12,2019-20
24,2019-12-27,New Jersey Devils,Away,OT Win,5,4,1,0.992,1.008,37,28,9,0.135,0.143,27,28,-1,0.4909,0.8571,0.8649,8,24,-16,8,16,-8,2019-20
25,2019-12-23,Carolina Hurricanes,Home,Win,8,6,2,1.055,0.966,39,40,-1,0.205,0.15,28,32,-4,0.4667,0.85,0.8158,4,19,-15,14,10,4,2019-20
26,2019-12-21,Detroit Red Wings,Home,Win,4,1,3,1.141,0.859,23,30,-7,0.174,0.033,26,21,5,0.5532,0.9667,0.8261,14,26,-12,7,12,-5,2019-20
27,2019-12-20,New York Rangers,Away,Win,6,3,3,1.014,0.986,40,22,18,0.15,0.136,28,29,-1,0.4912,0.8636,0.85,13,23,-10,11,15,-4,2019-20
28,2019-12-17,Buffalo Sabres,Home,Win,5,3,2,1.052,0.975,33,30,3,0.152,0.1,32,18,14,0.64,0.9,0.875,16,25,-9,13,10,3,2019-20
29,2019-12-14,Edmonton Oilers,Away,Win,4,1,3,1.098,0.93,32,37,-5,0.125,0.027,27,30,-3,0.4737,0.973,0.9032,21,29,-8,13,8,5,2019-20
30,2019-12-12,Calgary Flames,Away,Loss,2,4,-2,0.892,1.108,34,24,10,0.059,0.167,24,30,-6,0.4444,0.8333,0.9412,12,22,-10,12,18,-6,2019-20
31,2019-12-10,Vancouver Canucks,Away,Win,4,1,3,1.128,0.906,26,39,-13,0.154,0.026,28,23,5,0.549,0.9744,0.88,8,15,-7,13,16,-3,2019-20
32,2019-12-07,St. Louis Blues,Away,Win,5,2,3,1.114,0.886,27,28,-1,0.185,0.071,23,31,-8,0.4259,0.9286,0.8148,9,24,-15,14,19,-5,2019-20
33,2019-12-04,Colorado Avalanche,Home,Loss,1,3,-2,0.957,1.074,39,30,9,0.026,0.1,35,19,16,0.6481,0.931,0.9744,17,24,-7,19,11,8,2019-20
34,2019-12-03,Philadelphia Flyers,Away,Loss,1,6,-5,0.857,1.171,28,29,-1,0.036,0.207,20,30,-10,0.4,0.8214,0.9643,12,21,-9,20,8,12,2019-20
35,2019-11-30,Buffalo Sabres,Home,OT Win,2,1,1,1.013,0.987,43,30,13,0.047,0.033,29,25,4,0.537,0.9667,0.9535,27,31,-4,11,11,0,2019-20
36,2019-11-29,Buffalo Sabres,Away,Loss,4,6,-2,0.995,1.029,29,36,-7,0.138,0.167,22,34,-12,0.3929,0.8571,0.8621,8,6,2,5,10,-5,2019-20
37,2019-11-27,Detroit Red Wings,Away,Win,6,0,6,1.111,0.889,54,25,29,0.111,0,31,25,6,0.5536,1,0.8889,14,25,-11,5,11,-6,2019-20
38,2019-11-23,Colorado Avalanche,Away,Win,5,3,2,1.097,0.933,28,37,-9,0.179,0.081,25,38,-13,0.3968,0.9189,0.8519,17,17,0,26,16,10,2019-20
39,2019-11-21,Arizona Coyotes,Away,Win,3,1,2,1.059,0.941,33,31,2,0.091,0.032,35,32,3,0.5224,0.9677,0.9091,17,28,-11,14,20,-6,2019-20
40,2019-11-19,Vegas Golden Knights,Away,Loss,2,4,-2,0.977,1.048,33,37,-4,0.061,0.108,35,30,5,0.5385,0.9167,0.9394,28,30,-2,19,22,-3,2019-20
41,2019-11-16,Pittsburgh Penguins,Away,Loss,1,6,-5,0.872,1.128,33,38,-5,0.03,0.158,39,18,21,0.6842,0.8421,0.9697,36,33,3,5,17,-12,2019-20
42,2019-11-15,Boston Bruins,Home,Loss,2,4,-2,0.974,1.053,31,34,-3,0.065,0.118,44,26,18,0.6286,0.9091,0.9355,24,35,-11,10,22,-12,2019-20
43,2019-11-13,New York Islanders,Away,Loss,4,5,-1,1.01,1.019,27,30,-3,0.148,0.167,20,24,-4,0.4545,0.8621,0.8519,22,40,-18,8,22,-14,2019-20
44,2019-11-10,Chicago Blackhawks,Away,Loss,4,5,-1,0.923,1.077,57,34,23,0.07,0.147,32,35,-3,0.4776,0.8529,0.9298,18,25,-7,15,13,2,2019-20
45,2019-11-09,Philadelphia Flyers,Home,SO Loss,2,3,-1,0.988,1.013,40,32,8,0.05,0.063,35,29,6,0.5469,0.9375,0.95,19,17,2,17,13,4,2019-20
46,2019-11-07,Vegas Golden Knights,Home,OT Win,2,1,1,1.028,0.972,37,38,-1,0.054,0.026,36,31,5,0.5373,0.9737,0.9459,23,29,-6,19,20,-1,2019-20
47,2019-11-05,Los Angeles Kings,Home,Win,3,1,2,1.09,0.91,23,25,-2,0.13,0.04,31,23,8,0.5741,0.96,0.8696,25,24,1,12,16,-4,2019-20
48,2019-11-02,Philadelphia Flyers,Away,SO Win,4,3,1,1.04,0.96,26,40,-14,0.115,0.075,20,31,-11,0.3922,0.925,0.8846,28,23,5,11,15,-4,2019-20
49,2019-10-29,Washington Capitals,Home,OT Loss,3,4,-1,0.976,1.024,31,33,-2,0.097,0.121,48,32,16,0.6,0.8788,0.9032,12,18,-6,11,12,-1,2019-20
50,2019-10-26,Montreal Canadiens,Away,Loss,2,5,-3,0.933,1.067,31,38,-7,0.065,0.132,35,33,2,0.5147,0.8684,0.9355,32,29,3,14,17,-3,2019-20
51,2019-10-25,San Jose Sharks,Home,Win,4,1,3,1.089,0.943,27,17,10,0.148,0.059,19,18,1,0.5135,0.9412,0.8846,12,19,-7,11,16,-5,2019-20
52,2019-10-22,Boston Bruins,Away,Loss,2,4,-2,0.964,1.036,30,39,-9,0.067,0.103,25,38,-13,0.3968,0.8974,0.9333,16,32,-16,9,8,1,2019-20
53,2019-10-21,Columbus Blue Jackets,Home,OT Loss,3,4,-1,0.992,1.008,31,38,-7,0.097,0.105,43,22,21,0.6615,0.8947,0.9032,26,15,11,11,18,-7,2019-20
54,2019-10-19,Boston Bruins,Home,OT Win,4,3,1,1.073,0.927,29,46,-17,0.138,0.065,26,23,3,0.5306,0.9348,0.8621,36,34,2,14,9,5,2019-20
55,2019-10-16,Washington Capitals,Away,Loss,3,4,-1,0.969,1.031,32,32,0,0.094,0.125,30,27,3,0.5263,0.875,0.9063,9,31,-22,17,24,-7,2019-20
56,2019-10-15,Minnesota Wild,Home,Win,4,2,2,1.049,0.951,34,29,5,0.118,0.069,29,24,5,0.5472,0.931,0.8824,11,31,-20,11,15,-4,2019-20
57,2019-10-12,Detroit Red Wings,Away,Win,5,2,3,1.048,0.974,41,27,14,0.122,0.074,34,24,10,0.5862,0.9259,0.9,14,21,-7,12,24,-12,2019-20
58,2019-10-10,Tampa Bay Lightning,Home,Loss,3,7,-4,0.895,1.105,28,33,-5,0.107,0.212,30,24,6,0.5556,0.7879,0.8929,15,25,-10,14,19,-5,2019-20
59,2019-10-07,St. Louis Blues,Home,Loss,2,3,-1,0.959,1.041,34,30,4,0.059,0.1,28,28,0,0.5,0.9,0.9412,15,26,-11,9,18,-9,2019-20
60,2019-10-05,Montreal Canadiens,Home,SO Loss,5,6,-1,1.016,0.984,37,42,-5,0.135,0.119,39,33,6,0.5417,0.881,0.8649,19,26,-7,18,15,3,2019-20
61,2019-10-04,Columbus Blue Jackets,Away,Win,4,1,3,1.103,0.897,29,29,0,0.138,0.034,34,24,10,0.5862,0.9655,0.8621,18,20,-2,13,17,-4,2019-20
62,2019-10-02,Ottawa Senators,Home,Win,5,3,2,1.004,0.996,42,26,16,0.119,0.115,31,42,-11,0.4247,0.8846,0.881,17,44,-27,9,17,-8,2019-20
